12 2 12

XXXXXXXXXXXX
X**********X
XXX*XXXXXXXX
X**********X
X*XXXXXXXXXX
X**********X
XXX*XXXXXXXX
X**********X
XXXXXXX*XXXX
X**********X
XXXXXX*XXX*X
XXXXXXXXXX**

XXXXXXXXXXXX
X..........X
XXX.XXXXXXXX
X..........X
X.XXXXXXXXXX
X..........X
XXX.XXXXXXXX
X..........X
XXXXXXX.XXXX
X..........X
XXXXXX.XXX.X
XXXXXXXXXX..
