5 2 5

XXXXX
X***X
XXX*X
X***X
XXX**

XXXXX
X...X
XXX.X
X...X
XXX..
