*****
***x*
***x*
*xxx*
*****
