**********
X*XXXXXXXX
**********
XXXXX*XXXX
**********
XXXX*XXXXX
**********
XXX*XXXXXX
**********
XXXXXX*XX*
